NO ./textures/mossy.xpm
SO ./textures/redbrick.xpm
WE ./textures/colorstone.xpm
EA ./textures/greystone.xpm

F 51,102,0
C 0,204,204
        1111111111111111111111111
        1000000000110000000000001
        1011000001110000000000001
        1001000000000000000000001
111111111011000001110000000000001
100000000011000001110111111111111
11110111111111011100000000001
111101111111110111011100000001
11000000110101011101000010001
10000000100000001000000000N01
10000000000000001101010000001
1100000111010101 11101111000111
11110111 1110101 101111110001
11111111 1111111 111111 11111